10.ox
..o....o..oo...o...o...oo...o.o.o......oo.o.......o..oo.......................o.o..oo..ooo........o.
......o........o......o...o..o...........o............o......o....oo.o.o...oo.ooo...o...o....o.....o
oo...o....o.................o.............o..o....o...ooo....o.....o..o......o........o.oo..........
...o...............oo..o..........o................o....o.o.o......o.o.o...o.o........ooo......o....
..o..o..............o..........o.o..o....o....ooo.....o..oooooo...o..oo.............o...............
...o...o...o.ooo..o......o...........o.o......o.o....o...oo.............o......................o....
...........o......o.....o..............o................oo.o.....o..o..o.o.............o.o.oo..o...o
o.oo.......o..o............o.o.....o...o...........o.o...o............o......o..o.o..o.o...o....o..o
o....o.o........o..o......o..o......o....o..............oo.o...o................o..o.......o.oo..oo.
....oo..oo.........o.oo.oo...o..........o....o.......o.o.........o.o.........o..............o.o.....
